A 1
* * B * .
+ . . 9 .
. . 0 . .
. . . . C
1 . . . .
B 2
1 . . . .
. . . 1 .
* * 1 . .
. . . . .
1 . A . .
C 3
1 . . . .
. . . 1 .
. . 1 . .
A . . . .
. . . . .
