A 5 5 1
* * B * .
* . . 9 .
. . 0 . .
. . . . C
1 . . . .
B 5 5 2
1 . . . .
. . . 1 .
* * 1 . .
. . . . .
1 . A . .
C 5 5 3
1 . . . .
. . . 1 .
. . 1 . .
A . . . .
. . . . .
