A 1
5 5
* * B * .
+ . . 9 .
. . 0 . .
. . . . C
1 . . . .
B 1
5 5
1 . . . .
. . . 1 .
* * 1 . .
. . . . .
1 . A . .
C 9
5 5
1 . . . .
. . . 1 .
. . 1 . .
A . . . .
. . . . .
